fiscalDateEnding,reportedCurrency,totalAssets,totalCurrentAssets,cashAndCashEquivalentsAtCarryingValue,cashAndShortTermInvestments,inventory,currentNetReceivables,totalNonCurrentAssets,propertyPlantEquipment,accumulatedDepreciationAmortizationPPE,intangibleAssets,intangibleAssetsExcludingGoodwill,goodwill,investments,longTermInvestments,shortTermInvestments,otherCurrentAssets,otherNonCurrentAssets,totalLiabilities,totalCurrentLiabilities,currentAccountsPayable,deferredRevenue,currentDebt,shortTermDebt,totalNonCurrentLiabilities,capitalLeaseObligations,longTermDebt,currentLongTermDebt,longTermDebtNoncurrent,shortLongTermDebtTotal,otherCurrentLiabilities,otherNonCurrentLiabilities,totalShareholderEquity,treasuryStock,retainedEarnings,commonStock,commonStockSharesOutstanding
2022-09-30,USD,36491000000,12328000000,1480000000,1480000000,5153000000,4329000000,24163000000,14823000000,7817000000,2340000000,594000000,1746000000,5461000000,4386000000,0,1366000000,845000000,24300000000,7634000000,3508000000,179000000,871000000,439000000,16538000000,1514000000,10445000000,432000000,None,439000000,2633000000,2106000000,12191000000,1348000000,9232000000,19000000,325623082
2022-06-30,USD,37024000000,12845000000,1057000000,1057000000,5097000000,5407000000,24179000000,14741000000,7923000000,2414000000,621000000,1793000000,5113000000,4544000000,0,1284000000,617000000,24794000000,7653000000,4103000000,196000000,413000000,405000000,17011000000,1569000000,11062000000,8000000,None,405000000,2434000000,1939000000,12230000000,1200000000,9050000000,19000000,327244650
2022-03-31,USD,37854000000,13291000000,1785000000,1785000000,4979000000,5391000000,24563000000,14729000000,8004000000,2539000000,673000000,1866000000,5832000000,4743000000,0,1136000000,647000000,25156000000,7539000000,4238000000,214000000,149000000,141000000,17487000000,1610000000,11175000000,8000000,None,141000000,2376000000,2215000000,12698000000,1156000000,9514000000,19000000,327644034
2021-12-31,USD,36742000000,12217000000,1472000000,1481000000,4901000000,5212000000,25055000000,14556000000,7826000000,2570000000,695000000,1875000000,5692000000,4786000000,9000000,623000000,667000000,24884000000,7230000000,3460000000,338000000,368000000,362000000,17524000000,1985000000,11753000000,6000000,None,12115000000,1453000000,2295000000,11858000000,965000000,8563000000,19000000,329536389
2021-09-30,USD,38662000000,13986000000,1893000000,1929000000,4982000000,5251000000,24676000000,14836000000,7739000000,2560000000,666000000,1894000000,4888000000,4888000000,36000000,1824000000,603000000,26862000000,7408000000,3494000000,250000000,571000000,563000000,19324000000,1518000000,12945000000,8000000,None,563000000,2665000000,2383000000,11800000000,581000000,8216000000,19000000,333627352
2021-06-30,USD,37259000000,12897000000,1381000000,1517000000,4840000000,4897000000,24362000000,14645000000,7531000000,2608000000,677000000,1931000000,4902000000,4902000000,136000000,1643000000,573000000,26735000000,6595000000,2909000000,181000000,691000000,683000000,20010000000,1364000000,13482000000,8000000,None,683000000,2418000000,2657000000,10524000000,494000000,6837000000,19000000,334503518
2021-03-31,USD,35746000000,11964000000,1452000000,1835000000,4632000000,3961000000,23782000000,14390000000,7241000000,2621000000,717000000,1904000000,4794000000,4794000000,383000000,1536000000,511000000,26946000000,6875000000,2703000000,185000000,1640000000,682000000,19941000000,1199000000,13785000000,958000000,None,682000000,1953000000,2554000000,8800000000,506000000,5158000000,19000000,334313140
2020-12-31,USD,35403000000,11634000000,1763000000,2465000000,4344000000,4489000000,24085000000,14386000000,7098000000,2704000000,751000000,1953000000,5757000000,4729000000,702000000,336000000,458000000,27432000000,5502000000,2398000000,351000000,671000000,663000000,21797000000,1532000000,16063000000,8000000,None,16726000000,1416000000,2957000000,7971000000,531000000,4440000000,19000000,334015220
2020-09-30,USD,31949000000,10759000000,2459000000,2820000000,4005000000,2974000000,20655000000,14133000000,6750000000,2632000000,752000000,1880000000,2085000000,2085000000,361000000,960000000,419000000,24643000000,4782000000,2013000000,199000000,618000000,616000000,19728000000,1122000000,13759000000,2000000,None,616000000,1685000000,3038000000,7306000000,540000000,3940000000,19000000,333918359
2020-06-30,USD,31541000000,10477000000,2552000000,3203000000,3768000000,2588000000,20518000000,14526000000,7493000000,2586000000,756000000,1830000000,1559000000,1559000000,651000000,918000000,422000000,24183000000,4435000000,1790000000,147000000,662000000,659000000,16642000000,1160000000,13674000000,3000000,None,659000000,1579000000,2968000000,7358000000,548000000,4188000000,19000000,333829804
2020-03-31,USD,31100000000,9692000000,1596000000,1795000000,3973000000,3043000000,20889000000,14387000000,7277000000,2608000000,808000000,1800000000,1539000000,1539000000,199000000,881000000,902000000,23776000000,5521000000,2217000000,151000000,1496000000,1493000000,14967000000,1192000000,12159000000,3000000,None,1493000000,-574000000,2808000000,7324000000,559000000,4227000000,19000000,333703450
2019-12-31,USD,30435000000,9510000000,858000000,1054000000,4588000000,3455000000,20687000000,14130000000,7130000000,2760000000,869000000,1891000000,2361000000,1602000000,196000000,766000000,461000000,22391000000,5198000000,2516000000,227000000,448000000,445000000,13827000000,1489000000,12167000000,3000000,None,12612000000,1549000000,2213000000,8044000000,580000000,4435000000,19000000,333476883
2019-09-30,USD,30114000000,9630000000,476000000,529000000,4446000000,3469000000,19974000000,13669000000,6859000000,2689000000,841000000,1848000000,1609000000,1609000000,53000000,1186000000,497000000,22226000000,7388000000,2687000000,143000000,2442000000,2438000000,11429000000,1257000000,9628000000,4000000,None,2438000000,1745000000,1801000000,7888000000,5898000000,8430000000,22000000,333407876
2019-06-30,USD,31171000000,11088000000,1279000000,1331000000,4685000000,3758000000,18010000000,13285000000,6704000000,2740000000,892000000,1848000000,1599000000,1599000000,52000000,1314000000,386000000,20450000000,7538000000,2584000000,None,2816000000,2812000000,9462000000,1304000000,7586000000,4000000,None,2812000000,1607000000,1876000000,10721000000,2663000000,7818000000,22000000,370387374
2019-03-31,USD,29889000000,10286000000,339000000,762000000,4496000000,3680000000,17582000000,12797000000,6447000000,2748000000,945000000,1803000000,1650000000,1650000000,423000000,1348000000,387000000,19751000000,7012000000,2610000000,None,2382000000,2377000000,9352000000,1282000000,7522000000,5000000,None,2377000000,-524000000,1830000000,10138000000,2668000000,7206000000,22000000,370326103
2018-12-31,USD,28278000000,10566000000,332000000,1224000000,4515000000,3890000000,17389000000,12477000000,6224000000,2779000000,965000000,1814000000,1871000000,1611000000,892000000,1324000000,353000000,18021000000,5513000000,2560000000,138000000,890000000,885000000,10394000000,None,9554000000,5000000,None,10439000000,-439000000,1897000000,10257000000,2206000000,6763000000,22000000,375696661
2018-09-30,USD,28696000000,11383000000,521000000,1465000000,4596000000,4087000000,16853000000,12022000000,6094000000,2801000000,982000000,1819000000,1688000000,1688000000,944000000,1235000000,342000000,17652000000,6242000000,2928000000,None,1198000000,214000000,9488000000,None,7557000000,984000000,None,214000000,-285000000,2017000000,11044000000,1155000000,6453000000,22000000,387177776
2018-06-30,USD,27023000000,12349000000,2384000000,3317000000,4096000000,3889000000,14223000000,11310000000,5854000000,1090000000,528000000,562000000,2189000000,1599000000,933000000,1047000000,224000000,16421000000,5451000000,2489000000,None,1050000000,76000000,9295000000,None,7563000000,974000000,None,76000000,-368000000,1805000000,10602000000,16200000000,17939000000,31000000,390343283
2018-03-31,USD,26896000000,12068000000,1840000000,2882000000,4257000000,3859000000,14382000000,11249000000,5808000000,1145000000,567000000,578000000,2463000000,1767000000,1042000000,1070000000,221000000,17168000000,4598000000,2379000000,None,82000000,77000000,10881000000,None,8531000000,5000000,None,77000000,-182000000,2350000000,9728000000,15865000000,16677000000,31000000,393482424
2017-12-31,USD,26206000000,11738000000,1523000000,2830000000,4217000000,3752000000,14105000000,10997000000,5573000000,1138000000,568000000,570000000,3090000000,1635000000,1307000000,1332000000,261000000,17257000000,4777000000,2258000000,61000000,70000000,68000000,10824000000,None,8788000000,2000000,None,8856000000,794000000,2275000000,8949000000,15749000000,15746000000,31000000,394512054
